####################
#                  #
#  SSSSS           #
#                  #
#                  #
#                  #
#                  #
#     ####         #
#                  #
#                  #
#                  #
#                  #
#        ######    #
#                  #
#                  #
#     F            #
#                  #
#                  #
#                  #
####################
