##########################
#                        #
#  SSS                   #
#                        #
#                        #
#                        #
#                        #
#                        #
#                        #
#                        #
#          F             #
#                        #
#                        #
#                        #
#                        #
#                        #
#                        #
#                        #
#                        #
##########################
