##########################
####                  ####
###                    ###
##                      ##
#                        #
#                        #
#      ####       ###    #
#     ##  ##    ###      #
#    ##    ## ###        #
#                        #
#  SSS                   #
#                        #
#     ##############     #
#    ################    #
#     ##############     #
#                        #
##            F         ##
###                    ###
####                  ####
##########################
