####################
#                  #
#                  #
#                  #
#                  #
#   ####      ###  #
#  #    #   ##     #
#                  #
#                  #
#                  #
#   ############   #
#                  #
#                  #
#  S               #
#                  #
#                  #
#             F    #
#                  #
#                  #
####################
