##########################
#                        #
#  SSS                   #
#                        #
#                        #
#                        #
#                        #
#     ########           #
#                        #
#                        #
#                        #
#                        #
#        ##########      #
#                        #
#                        #
#     F                  #
#                        #
#                        #
#                        #
##########################
