####################
#                  #
#  S               #
#                  #
#                  #
#                  #
#                  #
#                  #
#                  #
#                  #
#          F       #
#                  #
#                  #
#                  #
#                  #
#                  #
#                  #
#                  #
#                  #
####################
