####################
#                  #
#  SSS             #
#                  #
#                  #
#                  #
#                  #
#                  #
#                  #
#                  #
#          F       #
#                  #
#                  #
#                  #
#                  #
#                  #
#                  #
#                  #
#                  #
####################
