####################
#                  #
#  SSS             #
#                  #
#                  #
#                  #
#                  #
#     ####         #
#                  #
#                  #
#                  #
#                  #
#        ######    #
#                  #
#                  #
#     F            #
#                  #
#                  #
#                  #
####################
