##########################
#                        #
#  SSS                   #
#                        #
#                        #
#   ##    ##  ##   ##    #
#   #x#  #xx# #x# #xx#   #
#   ##x  #xx# ##x #xx#   #
#   #x#  #xx# #x# #xx#   #
#   #  #  ##  ##   ##    #
#                        #
#      ##  ##  #   #     #
#     #   #xx# ##  #     #
#     #   #xx# #x#x#     #
#     #   #xx# #  ##     #
#      ##  ##  #   #     #
#                        #
#      F                 #
#                        #
##########################