####################
####            ####
###              ###
##                ##
#                  #
#    ####     ###  #
#   #    #  ###    #
#                  #
#                  #
#                  #
#  S               #
#                  #
#   ############   #
#                  #
#                  #
#                  #
##            F   ##
###              ###
####            ####
####################
