####################
#                  #
#  S               #
#                  #
#                  #
#                  #
#                  #
#     ####         #
#                  #
#                  #
#          F       #
#                  #
#          ######  #
#                  #
#                  #
#                  #
#                  #
#                  #
#                  #
####################
